S.no,City,Number of Beds,Number of Homes,Province,Population,NoB required (raw),NoB req,Discrepancy
1,airdrie,74,2,Alberta,61581,1966.638007,1967,1893
2,athabasca,100,2,Alberta,2965,94.68962328,95,-5
3,banff,47,1,Alberta,7847,250.6001598,251,204
4,barrhead,176,5,Alberta,4579,146.2339916,147,-29
5,bashaw,30,2,Alberta,873,27.87994642,28,-2
6,bassano,12,1,Alberta,1206,38.51456515,39,27
7,beaumont,46,1,Alberta,17396,555.5550376,556,510
8,beaverlodge,18,1,Alberta,2465,78.72172728,79,61
9,bentley,16,1,Alberta,1078,34.42678378,35,19
10,black diamond,45,1,Alberta,2700,86.2266384,87,42
11,blackfoot,6,1,Alberta,269,8.590728048,9,3
12,bonnyville,133,4,Alberta,5975,190.8163572,191,58
13,bow island,50,2,Alberta,1983,63.32867554,64,14
14,boyle,20,1,Alberta,916,29.25318547,30,10
15,breton,23,1,Alberta,496,15.84015283,16,-7
16,brooks,161,3,Alberta,14451,461.5041302,462,301
17,calgary,8058,91,Alberta,1239220,39575.47216,39576,31518
18,camrose,458,9,Alberta,18742,598.5406137,599,141
19,canmore,23,2,Alberta,13992,446.8456017,447,424
20,cardston,146,3,Alberta,3585,114.4898143,115,-31
21,castor,27,1,Alberta,932,29.76415814,30,3
22,claresholm,100,4,Alberta,3780,120.7172938,121,21
23,coaldale,89,2,Alberta,8215,262.3525313,263,174
24,cochrane,78,2,Alberta,25853,825.6360306,826,748
25,cold lake,97,2,Alberta,14961,477.7913841,478,381
26,consort,20,1,Alberta,689,22.00376069,23,3
27,coronation,52,1,Alberta,947,30.24319502,31,-21
28,daysland,42,2,Alberta,807,25.77218414,26,-16
29,desmarais,10,1,Alberta,138,4.407139296,5,-5
30,devon,24,1,Alberta,6578,210.0736398,211,187
31,didsbury,167,3,Alberta,5268,168.2377523,169,2
32,drayton valley,114,4,Alberta,7235,231.0554551,232,118
33,drumheller,174,4,Alberta,7982,254.9114917,255,81
34,eckville,15,1,Alberta,1125,35.927766,36,21
35,edmonton,10293,92,Alberta,1062643,33936.34582,33937,23644
36,edson,108,2,Alberta,8414,268.7077539,269,161
37,elk point,52,2,Alberta,1452,46.37076998,47,-5
38,evansburg,40,1,Alberta,880,28.10349696,29,-11
39,fairview,92,1,Alberta,162,5.173598304,6,-86
40,fort macleod,68,3,Alberta,2967,94.75349486,95,27
41,fort saskatchewan,121,2,Alberta,24149,771.217441,772,651
42,fort vermilion,34,1,Alberta,727,23.21732078,24,-10
43,fox creek,4,1,Alberta,1971,62.94544603,63,59
44,galahad,20,1,Alberta,119,3.800359248,4,-16
45,grande cache,27,2,Alberta,3571,114.0427132,115,88
46,grande prairie,575,7,Alberta,63166,2017.256237,2018,1443
47,grimshaw,76,2,Alberta,2718,86.80148266,87,11
48,hanna,78,1,Alberta,2559,81.72369173,82,4
49,hardisty,20,1,Alberta,639,20.40697109,21,1
50,high level,45,2,Alberta,3159,100.8851669,101,56
51,high prairie,78,3,Alberta,2564,81.88337069,82,4
52,high river,185,3,Alberta,13584,433.8157985,434,249
53,hinton,75,3,Alberta,9882,315.5894965,316,241
54,hythe,31,1,Alberta,820,26.18734944,27,-4
55,innisfail,208,2,Alberta,7847,250.6001598,251,43
56,islay,20,1,Alberta,208,6.642644736,7,-13
57,jasper,27,2,Alberta,4590,146.5852853,147,120
58,killam,50,1,Alberta,981,31.32901195,32,-18
59,la crete,77,3,Alberta,523,16.70241922,17,-60
60,lac la biche,64,1,Alberta,2520,80.47819584,81,17
61,lacombe,221,2,Alberta,13057,416.9856361,417,196
62,lamont,120,1,Alberta,1774,56.65409501,57,-63
63,leduc,329,4,Alberta,29993,957.8502095,958,629
64,lethbridge,1425,17,Alberta,92729,2961.374056,2962,1537
65,linden,37,1,Alberta,725,23.1534492,24,-13
66,lloydminster,170,3,Alberta,31410,1003.103227,1004,834
67,magrath,35,2,Alberta,2374,75.81557021,76,41
68,manning,27,1,Alberta,1183,37.78004194,38,11
69,mannville,23,1,Alberta,803,25.64444098,26,3
70,mayerthorpe,120,3,Alberta,1320,42.15524544,43,-77
71,mclennan,77,2,Alberta,809,25.83605573,26,-51
72,medicine hat,964,14,Alberta,63260,2020.258202,2021,1057
73,milk river,34,2,Alberta,811,25.89992731,26,-8
74,morinville,74,1,Alberta,9848,314.5036796,315,241
75,mundare,30,1,Alberta,855,27.30510216,28,-2
76,myrnam,9,1,Alberta,370,11.81624304,12,3
77,nanton,38,1,Alberta,2181,69.65196235,70,32
78,okotoks,200,4,Alberta,28881,922.3376088,923,723
79,olds,163,3,Alberta,9184,293.2983137,294,131
80,onoway,15,1,Alberta,1029,32.86192997,33,18
81,oyen,40,1,Alberta,1001,31.96772779,32,-8
82,peace river,113,3,Alberta,6842,218.5046889,219,106
83,pincher creek,94,2,Alberta,3642,116.3101545,117,23
84,ponoka,480,4,Alberta,7229,230.8638404,231,-249
85,provost,62,1,Alberta,1998,63.80771242,64,2
86,radway,30,1,Alberta,162,5.173598304,6,-24
87,rainbow lake,2,1,Alberta,870,27.78413904,28,26
88,raymond,102,2,Alberta,3708,118.4179167,119,17
89,red deer,1112,12,Alberta,100418,3206.928361,3207,2095
90,redwater,21,1,Alberta,2053,65.56418098,66,45
91,rimbey,107,1,Alberta,2567,81.97917806,82,-25
92,slave lake,97,4,Alberta,6651,212.4049526,213,116
93,smoky lake,63,2,Alberta,1022,32.63837942,33,-30
94,spirit river,28,1,Alberta,1025,32.7341868,33,5
95,st. albert,826,8,Alberta,65589,2094.636661,2095,1269
96,st. paul,11,1,Alberta,5827,186.08986,187,176
97,stettler,164,2,Alberta,5952,190.081834,191,27
98,stony plain,255,3,Alberta,17189,548.9443287,549,294
99,strathmore,188,2,Alberta,13756,439.3087548,440,252
100,sundre,63,2,Alberta,2729,87.15277637,88,25
101,swan hills,4,1,Alberta,1301,41.54846539,42,38
102,sylvan lake,61,2,Alberta,14816,473.1606943,474,413
103,taber,154,3,Alberta,8428,269.154855,270,116
104,three hills,60,2,Alberta,3212,102.5777639,103,43
105,tofield,66,1,Alberta,2081,66.45838315,67,1
106,trochu,28,1,Alberta,1058,33.78806794,34,6
107,two hills,83,1,Alberta,1352,43.17719078,44,-39
108,valleyview,45,1,Alberta,1863,59.4963805,60,15
109,vegreville,182,5,Alberta,5708,182.2895007,183,1
110,vermilion,113,2,Alberta,4084,130.4257745,131,18
111,viking,76,2,Alberta,1083,34.58646274,35,-41
112,villeneuve,32,1,Alberta,136,4.343267712,5,-27
113,vilna,12,1,Alberta,249,7.952012208,8,-4
114,vulcan,69,2,Alberta,1917,61.22091326,62,-7
115,wainwright,153,2,Alberta,6270,200.2374158,201,48
116,westlock,212,2,Alberta,5101,162.904475,163,-49
117,wetaskiwin,297,5,Alberta,12655,404.1474478,405,108
118,whitecourt,37,2,Alberta,1082,34.55452694,35,-2
