S.no,City,Number of Beds,Number of Homes,Province,Population,NoB required (raw),NoB req,Discrepancy
1,acton vale,25,2,Quebec,7664,1078.876608,1079,1054
2,adstock,1,1,Quebec,2806,395.006232,396,395
3,alma,34,9,Quebec,30904,4350.417888,4351,4317
4,amos,5,3,Quebec,12823,1805.119356,1806,1801
5,amqui,1,1,Quebec,6322,889.960584,890,889
6,asbestos,13,2,Quebec,7096,998.918112,999,986
7,ayer's cliff,1,1,Quebec,1109,156.116148,157,156
8,aylmer,16,2,Quebec,7492,1054.663824,1055,1039
9,baie-comeau,9,5,Quebec,21536,3031.665792,3032,3023
10,baie-d'urfe,4,1,Quebec,3850,541.9722,542,538
11,beaconsfield,11,4,Quebec,19115,2690.85678,2691,2680
12,beauceville,6,3,Quebec,6354,894.465288,895,889
13,beauharnois,14,3,Quebec,12011,1690.812492,1691,1677
14,beaumont,1,1,Quebec,17396,2448.869712,2449,2448
15,beauport,54,6,Quebec,7281,1024.960932,1025,971
16,becancour,2,1,Quebec,12438,1750.922136,1751,1749
17,bécancour,2,2,Quebec,20081,2826.842532,2827,2825
18,bedford,1,1,Quebec,2684,377.832048,378,377
19,beloeil,2,1,Quebec,50796,7150.654512,7151,7149
20,blainville,24,4,Quebec,56363,7934.332236,7935,7911
21,boisbriand,2,1,Quebec,26884,3784.514448,3785,3783
22,boischatel,10,2,Quebec,6465,910.09098,911,901
23,bois-des-filion,3,1,Quebec,9485,1335.22242,1336,1333
24,bonaventure,1,1,Quebec,2775,390.6423,391,390
25,boucherville,40,7,Quebec,40753,5736.881316,5737,5697
26,brossard,111,7,Quebec,85721,12067.11661,12068,11957
27,burnaby,1,1,Quebec,232755,32765.38686,32766,32765
28,candiac,2,1,Quebec,21047,2962.828284,2963,2961
29,chambly,2,1,Quebec,29120,4099.28064,4100,4098
30,chandler,8,2,Quebec,7703,1084.366716,1085,1077
31,chateauguay,8,4,Quebec,70812,9968.346864,9969,9961
32,châteauguay,17,3,Quebec,45904,6461.997888,6462,6445
33,chateau-richer,12,1,Quebec,4126,580.825272,581,569
34,château-richer,4,1,Quebec,3834,539.719848,540,536
35,cheneville,1,1,Quebec,792,111.491424,112,111
36,chertsey,1,1,Quebec,4836,680.773392,681,680
37,cleveland,1,1,Quebec,1609,226.502148,227,226
38,coaticook,11,2,Quebec,8698,1224.434856,1225,1214
39,compton,1,1,Quebec,3112,438.082464,439,438
40,contrecoeur,3,1,Quebec,6252,880.106544,881,878
41,cowansville,25,4,Quebec,12489,1758.101508,1759,1734
42,danville,6,1,Quebec,4070,572.94204,573,567
43,degelis,2,2,Quebec,3051,429.495372,430,428
44,deux-montagnes,1,1,Quebec,17553,2470.970916,2471,2470
45,disraeli,4,1,Quebec,2502,352.211544,353,349
46,dolbeau-mistassini,23,5,Quebec,14384,2024.864448,2025,2002
47,dollard-des-ormeaux,86,3,Quebec,49637,6987.499764,6988,6902
48,dorval,63,2,Quebec,18980,2671.85256,2672,2609
49,drummondville,111,15,Quebec,68601,9657.099972,9658,9547
50,east broughton,9,1,Quebec,2229,313.780788,314,305
51,ferme-neuve,1,1,Quebec,2822,397.258584,398,397
52,forestville,1,1,Quebec,3270,460.32444,461,460
53,fortierville,4,1,Quebec,448,63.065856,64,60
54,gaspe,11,3,Quebec,15163,2134.525836,2135,2124
55,gatineau,131,23,Quebec,276245,38887.56114,38888,38757
56,gracefield,6,1,Quebec,2462,346.580664,347,341
57,granby,81,14,Quebec,63433,8929.590276,8930,8849
58,ham-nord,1,1,Quebec,832,117.122304,118,117
59,hebertville,4,1,Quebec,2441,343.624452,344,340
60,hinchinbrooke,1,1,Quebec,2103,296.043516,297,296
61,huntingdon,3,1,Quebec,2444,344.046768,345,342
62,innisfail,1,1,Quebec,7847,1104.637884,1105,1104
63,joliette,85,8,Quebec,19621,2762.087412,2763,2678
64,kamouraska,2,1,Quebec,332,46.736304,47,45
65,kirkland,3,1,Quebec,20151,2836.696572,2837,2834
66,la prairie,15,3,Quebec,23357,3288.011604,3289,3274
67,la sarre,2,1,Quebec,7719,1086.619068,1087,1085
68,la tuque,4,2,Quebec,11001,1548.632772,1549,1545
69,lac-au-saumon,1,1,Quebec,1453,204.541716,205,204
70,lac-brome,5,1,Quebec,58889,8289.922308,8290,8285
71,lac-etchemin,10,1,Quebec,4061,571.675092,572,562
72,lachute,28,3,Quebec,12551,1766.829372,1767,1739
73,lac-megantic,7,3,Quebec,5932,835.059504,836,829
74,lambton,10,2,Quebec,1584,222.982848,223,213
75,lanoraie,20,3,Quebec,4787,673.875564,674,654
76,lasalle,83,2,Quebec,30180,4248.49896,4249,4166
77,l'ascension-de-notre-seigneur,3,2,Quebec,1983,279.150876,280,277
78,laval,761,48,Quebec,422993,59545.5706,59546,58785
79,lavaltrie,19,2,Quebec,13657,1922.523204,1923,1904
80,lebel-sur-quevillon,1,1,Quebec,2159,303.926748,304,303
81,l'epiphanie,4,1,Quebec,5353,753.552516,754,750
82,levis,68,23,Quebec,150000,21115.8,21116,21048
83,l'ele-perrot,21,2,Quebec,10503,1478.528316,1479,1458
84,l'islet,2,1,Quebec,841,118.389252,119,117
85,longueuil,178,21,Quebec,239700,33743.0484,33744,33566
86,lotbiniere,2,1,Quebec,29617,4169.244324,4170,4168
87,louiseville,17,5,Quebec,7517,1058.183124,1059,1042
88,lyster,1,1,Quebec,1628,229.176816,230,229
89,macamic,3,1,Quebec,2734,384.870648,385,382
90,magog,28,8,Quebec,25358,3569.696376,3570,3542
91,maniwaki,4,1,Quebec,3930,553.23396,554,550
92,mansfield-et-pontefract,1,1,Quebec,2285,321.66402,322,321
93,maria,18,4,Quebec,2536,356.997792,357,339
94,marieville,47,2,Quebec,10094,1420.952568,1421,1374
95,mascouche,42,4,Quebec,42491,5981.543052,5982,5940
96,matane,22,4,Quebec,14462,2035.844664,2036,2014
97,mcmasterville,2,1,Quebec,5615,790.43478,791,789
98,messines,5,1,Quebec,1608,226.361376,227,222
99,midland,1,1,Quebec,16864,2373.979008,2374,2373
100,mirabel,2,1,Quebec,50513,7110.816036,7111,7109
101,montebello,1,1,Quebec,978,137.675016,138,137
102,mont-joli,1,1,Quebec,6281,884.188932,885,884
103,mont-laurier,13,3,Quebec,13779,1939.697388,1940,1927
104,montmagny,10,5,Quebec,11491,1617.611052,1618,1608
105,montreal,3229,200,Quebec,3519595,495460.4273,495461,492232
106,mont-royal,2,1,Quebec,19503,2745.476316,2746,2744
107,mont-saint-hilaire,5,2,Quebec,18200,2562.0504,2563,2558
108,mont-tremblant,13,1,Quebec,9646,1357.886712,1358,1345
109,new carlisle,4,1,Quebec,1388,195.391536,196,192
110,new richmond,1,1,Quebec,3810,536.34132,537,536
111,nicolet,9,4,Quebec,7828,1101.963216,1102,1093
112,normandin,3,2,Quebec,3137,441.601764,442,439
113,notre-dame-des-pins,5,1,Quebec,1227,172.727244,173,168
114,notre-dame-du-bon-conseil,3,2,Quebec,1404,197.643888,198,195
115,ormstown,14,1,Quebec,3595,506.07534,507,493
116,pincourt,1,1,Quebec,14558,2049.358776,2050,2049
117,pont-rouge,3,1,Quebec,8723,1227.954156,1228,1225
118,portneuf,3,2,Quebec,3187,448.640364,449,446
119,prevost,1,1,Quebec,12171,1713.336012,1714,1713
120,quebec,290,2,Quebec,7903001,1112521.257,1112522,1112232
121,quebec city,769,74,Quebec,705103,99258.75952,99259,98490
122,racine,3,1,Quebec,1252,176.246544,177,174
123,rawdon,11,4,Quebec,10416,1466.281152,1467,1456
124,repentigny,73,8,Quebec,84965,11960.69298,11961,11888
125,richelieu,2,2,Quebec,5467,769.600524,770,768
126,richmond,4,1,Quebec,198309,27916.35455,27917,27913
127,rigaud,8,3,Quebec,7566,1065.080952,1066,1058
128,rimouski,11,5,Quebec,48664,6850.528608,6851,6840
129,riviere-bleue,2,1,Quebec,1299,182.862828,183,181
130,riviere-du-loup,8,6,Quebec,34375,4839.0375,4840,4832
131,riviere-rouge,14,1,Quebec,4645,653.88594,654,640
132,roberval,5,2,Quebec,10227,1439.675244,1440,1435
133,rosemere,17,1,Quebec,14294,2012.194968,2013,1996
134,rouyn-noranda,8,2,Quebec,42334,5959.441848,5960,5952
135,saguenay,63,9,Quebec,144746,20376.18391,20377,20314
136,saint-andre-avellin,20,2,Quebec,3702,521.137944,522,502
137,saint-augustin-de-desmaures,47,2,Quebec,18141,2553.744852,2554,2507
138,saint-basile-le-grand,23,2,Quebec,16736,2355.960192,2356,2333
139,saint-bernard,1,1,Quebec,2131,299.985132,300,299
140,saint-cesaire,1,1,Quebec,5686,800.429592,801,800
141,saint-charles-borromee,52,6,Quebec,13321,1875.223812,1876,1824
142,saint-damase,1,1,Quebec,2506,352.774632,353,352
143,sainte-adele,1,1,Quebec,12137,1708.549764,1709,1708
144,sainte-adele,1,1,Quebec,12137,1708.549764,1709,1708
145,sainte-agathe,3,1,Quebec,611,86.011692,87,84
146,sainte-agathe-des-monts,10,2,Quebec,10223,1439.112156,1440,1430
147,sainte-anne-de-bellevue,16,1,Quebec,4958,697.947576,698,682
148,sainte-catherine,6,4,Quebec,16762,2359.620264,2360,2354
149,sainte-claire,4,1,Quebec,3325,468.0669,469,465
150,sainte-croix,1,1,Quebec,2352,331.095744,332,331
151,sainte-henedine,9,1,Quebec,1212,170.615664,171,162
152,sainte-julie,13,2,Quebec,30104,4237.800288,4238,4225
153,sainte-justine,4,2,Quebec,1845,259.72434,260,256
154,sainte-luce,1,1,Quebec,2851,401.340972,402,401
155,sainte-marie,2,1,Quebec,12889,1814.410308,1815,1813
156,sainte-marie-salome,21,2,Quebec,1164,163.858608,164,143
157,sainte-monique,1,1,Quebec,212,29.843664,30,29
158,sainte-thecle,3,1,Quebec,2478,348.833016,349,346
159,sainte-therese,89,5,Quebec,26025,3663.5913,3664,3575
160,saint-eustache,68,7,Quebec,44154,6215.646888,6216,6148
161,saint-fabien-de-panet,2,1,Quebec,992,139.645824,140,138
162,saint-felicien,1,1,Quebec,10278,1446.854616,1447,1446
163,saint-gabriel,1,1,Quebec,2844,400.355568,401,400
164,saint-georges,20,5,Quebec,31173,4388.285556,4389,4369
165,saint-hyacinthe,149,9,Quebec,59614,8391.982008,8392,8243
166,saint-jean-de-dieu,2,1,Quebec,1606,226.079832,227,225
167,saint-jean-de-matha,2,1,Quebec,4335,610.24662,611,609
168,saint-jean-sur-richelieu,71,8,Quebec,92394,13006.48817,13007,12936
169,saint-jerome,106,11,Quebec,68456,9636.688032,9637,9531
170,saint-joseph-de-lepage,5,1,Quebec,527,74.186844,75,70
171,saint-lambert,123,8,Quebec,21861,3077.416692,3078,2955
172,saint-laurent,11,1,Quebec,215,30.26598,31,20
173,saint-leonard-d'aston,3,1,Quebec,982,138.238104,139,136
174,saint-liboire,2,1,Quebec,3051,429.495372,430,428
175,saint-ludger,3,1,Quebec,1255,176.66886,177,174
176,saint-mathieu,5,1,Quebec,1879,264.510588,265,260
177,saint-maurice,5,1,Quebec,2775,390.6423,391,386
178,saint-michel-des-saints,1,1,Quebec,2436,342.920592,343,342
179,saint-ours,2,1,Quebec,1721,242.268612,243,241
180,saint-pierre-les-becquets,1,1,Quebec,1223,172.164156,173,172
181,saint-raphael,9,1,Quebec,2463,346.721436,347,338
182,saint-raymond,9,1,Quebec,9615,1353.52278,1354,1345
183,saint-remi,11,3,Quebec,7265,1022.70858,1023,1012
184,saint-roch-de-l'achigan,4,1,Quebec,4892,688.656624,689,685
185,saint-sauveur,23,3,Quebec,9881,1390.968132,1391,1368
186,saint-tite,15,1,Quebec,3880,546.19536,547,532
187,saint-victor,13,1,Quebec,2430,342.07596,343,330
188,salaberry-de-valleyfield,99,12,Quebec,42410,5970.14052,5971,5872
189,selkirk,1,1,Quebec,10278,1446.854616,1447,1446
190,senneterre,1,1,Quebec,2953,415.699716,416,415
191,sept-iles,6,1,Quebec,28534,4016.788248,4017,4011
192,sept-iles,3,3,Quebec,25686,3615.869592,3616,3613
193,shawinigan,75,11,Quebec,50060,7047.04632,7048,6973
194,sherbrooke,132,22,Quebec,161323,22709.76136,22710,22578
195,sorel-tracy,44,8,Quebec,41629,5860.197588,5861,5817
196,stratford,1,1,Quebec,31465,4429.39098,4430,4429
197,temiscouata-sur-le-lac,1,1,Quebec,5096,717.374112,718,717
198,terrebonne,65,6,Quebec,111575,15706.6359,15707,15642
199,thetford mines,31,12,Quebec,25709,3619.107348,3620,3589
200,tring-jonction,1,1,Quebec,1473,207.357156,208,207
201,trois-pistoles,5,2,Quebec,3456,486.508032,487,482
202,trois-rivieres,182,23,Quebec,131338,18488.71294,18489,18307
203,valcourt,5,1,Quebec,2349,330.673428,331,326
204,varennes,24,2,Quebec,20994,2955.367368,2956,2932
205,vaudreuil-dorion,37,4,Quebec,38117,5365.806324,5366,5329
206,vaudreuil-soulanges,3,2,Quebec,139353,19617.00052,19618,19615
207,victoriaville,54,8,Quebec,45309,6378.238548,6379,6325
208,ville-marie,1,1,Quebec,2595,365.30334,366,365
209,warwick,9,2,Quebec,4766,670.919352,671,662
210,waterloo,9,2,Quebec,104986,14779.08919,14780,14771
211,westmount,21,2,Quebec,19931,2805.726732,2806,2785
212,windsor,2,1,Quebec,276165,38876.29938,38877,38875
213,winnipeg,11,1,Quebec,705244,99278.60837,99279,99268
